1111111111111111111111111111
1000P00000000111000000000001
1000000000000001001000000001
1000100000000100001000010001
1000100000000000001000100001
1000111000010000001000000001
1111111111111111111111111111