1111111111111111111
1000P00000000000001
1000000000000000001
1000100000000100001
1000100000000000001
1000000000010000001
1111111111111111111


 
        1111111111111011111111111
        1000000000110000000000001
        1011000001110000000000001
        1001000000000000000000001
111111111011000001110000000000001
100000000011000001110111111111111
11110111111111011100000010001
11110111111111011101010010001
11000000110101011100000010001
10000000000000001100000010001
10000000000000001101010010001
11000001110101011111011110N0111
11110111 1110111 101111010001
11111111 11111 1 111111111111
