1111111111111111111
1000000000000000001
1000000000000000001
1000100000000100001
1000100000000000001
1000000000010000001
1111111111111111111