NO ./textures/wall1.xpm
SO ./textures/wall2.xpm
WE ./textures/wall3.xpm
EA ./textures/wall4.xpm

F 244,164,96
C 175,238,238

        1111111111111111111111111
        110000000011000000N000001     
        1011001001110000000000001
        1111111111111111111111111