NO ./textures/north.xpm
SO ./textures/south.xpm
WE ./textures/west.xpm
EA ./textures/east.xpm

F 220,220,220
C 225,30,0

        1111111111111111111111111
        1100000000110000000000001     
        1011001001110000000000001
        1001000100000000000000001
111111111011000001110000000000001
100000000011000001110111111111111
11110111111111011100000010001
11110111111111011101010010001
11000000110101011100000000001
10000000000000001100000010001
10000000000000001101010011001
11000001110101011111011110N1111
11110111 1110101 101111011101
11111111 1111111 111111111111